-.......................................=
=.......................................-
-.......................................=
=.......................................-
-.......................................=
=.......................................-
-............................-..........=
=..............====-.........-..........=
-.......=...................-.....=.....-
=.....-.-....=-............-............=
-....=-=-====.....==--==..-.............-
=...==-.................-=....-=-.......=
-...............--...........-..........-
==.....-....................==..........=
-......-=--===--=-===-==----=--.........-
===.....-.................=..........-..=
-....--..........=.............-==---...-
=..........---=......-=-................=
-@..--+..-.-.........===-=.............--
-=-=-=-=-=-=-=-=-=-=-=-=-=-=-=-=-=-=-=-=-