-=-=-=-=-=-=-=-=-=-=-=-=-=-=-=-=-=-=-=-=-
=................................=......-
-....................+............@.....=
=..........=--==-==--.=..........-==..-=-
-.....................-.................=
=........-=...........-.................-
-......=..............-..=-.............=
=....=................=..=..............-
--..............=.....-..-.=-...........=
=..............=....-=-..-...-..........-
-..-..................=.......=====--====
=---==-=-=-.....-.......................-
-................-......................=
=.........-.......====-..--=-=-=-=--=...-
-.........=.............................=
=......................................=-
-.........-=-===--=--==-=--==-=-===----==
=.......................................-
-.......................................=
=.......................................-