-.......................................=
=.......................................-
-.......................................=
=.......................................-
-.......................................=
=.......................................-
-.......................................=
=.......................................-
-.......................................=
=.......................................-
-.......................................=
=.......................................-
-.......................................=
=.......................................-
-.......................................=
=.......................................-
-..................=....................=
=.........................-.............-
-..................-@..-==..............=
-=-=-=-=-=-=-=-=-=-=-=-=-=-=-=-=-=-=-=-=-
