-.......................................=
=.......................................-
-.......................................=
=.......................................-
-.......................................=
=.......................................-
-.......................................=
=.......................................-
-.......................................=
=.......................................-
-.......................................=
=.......................................-
-.......................................=
=.......................................-
-.......................................=
=.......................................-
-..................=....................=
=.........................-.............-
-..................-@..-==.............+=
-=-=-=-=-=-=-=-=-=-=-=-=-=-=-=-=-=-=-=-=-
