-.......................................=
=.......................................-
-.......................................=
=.......................................-
--......................................=
=.......................................-
-.......................................=
=................................-=.....-
-.......-==-=-=--=-=-=--=-=-=-=-=.......=
==-.....................................-
-......=...........................-=...=
=..................................=....-
-....-=...........=--==--=-=-=-.........=
==................................=.....-
-.....-...........-.....................=
=...=-=......==--=.........---==---....=-
-.....-............=....................=
=-........................-.............-
-=-................-@..-==.............+=
-=-=-=-=-=-=-=-=-=-=-=-=-=-=-=-=-=-=-=-=-
